10 11 11 11 11 11 11 11 11 11 11 10 10 11 11 11 11 11 11 11
10 11 13 13 13 13 13 13 13 13 11 10 10 11 13 13 13 13 13 13
10 11 13 13 13 13 13 13 13 13 11 10 10 11 13 13 13 13 13 13
10 11 12 12 12 12 12 12 12 12 11 10 10 11 12 12 12 17 12 15
10 11 12 12 12 12 12 12 12 12 11 10 10 11 12 12 12 17 12 15
10 11 11 11 11 12 12 12 12 12 11 10 10 11 12 12 12 17 12 15
10 13 13 13 11 12 12 12 12 12 11 10 10 11 12 12 12 11 11 11
10 13 13 13 11 12 12 12 12 12 11 11 11 11 12 12 12 11 13 13
10 10 10 10 11 12 12 12 12 12 13 13 13 13 12 12 12 11 13 13
11 11 11 11 11 12 12 12 12 12 13 13 13 13 12 12 12 11 10 10
13 13 13 13 13 12 12 12 12 12 12 12 12 12 12 12 12 11 10 10
13 13 13 13 13 12 12 12 12 12 12 12 12 12 12 12 12 11 10 10
15 12 17 12 12 12 12 12 12 12 12 12 11 12 12 12 12 11 10 10
15 12 17 12 12 12 12 11 11 11 11 11 11 12 12 12 12 11 10 10
15 12 17 12 12 12 12 11 13 13 13 13 11 12 12 12 12 11 10 10
11 11 11 12 12 12 12 11 13 13 13 13 11 11 11 11 11 11 10 10
13 13 11 12 12 12 12 11 10 10 10 10 13 13 13 13 13 13 10 10
13 13 11 11 11 11 11 11 10 10 10 10 13 13 13 13 13 13 10 10
10 10 13 13 13 13 13 13 10 10 10 10 10 10 10 10 10 10 10 10
10 10 13 13 13 13 13 13 10 10 10 10 10 10 10 10 10 10 10 10