10 11 11 11 11 11 11 11 11 11 11 10 10 10 10 10 10 10 10 10
10 11 13 13 13 14 13 13 13 14 11 10 10 10 10 10 10 10 10 10
10 11 13 14 13 13 13 13 14 13 11 11 11 11 11 11 11 11 10 10
10 11 12 12 12 12 12 12 12 12 13 13 13 13 14 13 13 11 10 10
10 11 12 12 12 12 16 12 12 12 13 14 13 13 13 13 14 11 10 10
10 11 12 12 12 12 12 12 12 12 12 12 12 12 12 12 12 11 10 10
10 11 16 12 12 12 12 12 12 12 12 12 12 12 12 16 12 11 10 10
10 11 12 12 12 12 12 12 12 12 12 16 12 12 12 12 12 11 11 11
10 11 12 12 12 12 12 16 12 12 12 12 12 12 12 12 12 13 14 11
10 11 12 12 12 12 12 12 12 12 12 12 12 12 12 16 12 13 13 11
10 11 12 12 16 12 12 12 12 16 12 12 12 12 12 12 12 12 12 13
10 11 11 12 12 12 11 11 11 11 11 11 12 12 12 12 12 12 12 13
10 11 13 12 12 12 13 11 13 13 13 11 12 12 12 12 16 12 12 15
10 11 13 12 12 16 13 11 13 13 13 11 12 16 12 12 12 12 12 15
10 11 12 12 12 12 12 11 10 10 10 11 12 12 12 12 12 12 12 15
10 11 16 12 12 12 12 11 10 10 10 11 12 12 12 12 12 16 12 11
10 11 12 12 12 12 12 11 10 10 10 11 12 12 12 12 12 12 12 11
10 11 11 11 11 11 11 11 10 10 10 11 11 11 11 11 11 11 11 11
10 13 13 13 13 13 14 13 10 10 10 13 14 13 13 13 13 13 14 13
10 14 13 13 14 13 13 13 10 10 10 13 13 13 13 14 13 13 13 14