11 11 11 11 11 11 11 11 11 11 11 11 11 11 11 11 11 11 11 11
11 13 13 13 13 13 13 13 13 13 13 13 13 13 13 13 13 13 13 11
11 13 13 13 13 13 13 13 13 13 13 13 13 13 13 13 13 13 13 11
11 12 12 12 12 12 12 12 12 12 12 12 12 12 12 12 12 12 12 11
11 12 12 12 12 12 12 12 12 12 12 12 12 12 12 12 12 12 12 11
11 12 12 12 12 12 12 12 12 12 12 12 12 12 12 12 12 12 12 13
11 12 12 12 12 12 12 12 12 12 12 12 12 12 12 12 12 12 12 13
11 12 12 12 12 12 12 12 12 12 12 12 12 12 12 12 12 12 12 15
11 12 12 12 12 12 12 12 12 12 12 12 12 12 12 12 12 12 12 15
11 12 12 12 12 12 12 12 12 12 12 12 12 12 12 12 12 12 12 15
11 12 12 12 12 12 12 12 12 12 12 12 12 12 12 12 12 12 12 11
11 12 12 12 12 12 12 12 12 12 12 12 12 12 12 12 12 12 12 11
11 12 12 12 12 12 12 12 12 12 12 12 12 12 12 12 12 12 12 11
11 12 12 12 12 12 12 12 12 12 12 12 12 12 12 12 12 12 12 11
11 12 12 12 12 12 12 12 12 12 12 12 12 12 12 12 12 12 12 11
11 12 12 12 12 12 12 12 12 12 12 12 12 12 12 12 12 12 12 11
11 12 12 12 12 12 12 12 12 12 12 12 12 12 12 12 12 12 12 11
11 11 11 11 11 11 11 11 11 11 11 11 11 11 11 11 11 11 11 11
13 13 13 13 13 13 13 13 13 13 13 13 13 13 13 13 13 13 13 13
13 13 13 13 13 13 13 13 13 13 13 13 13 13 13 13 13 13 13 13
